[
  {
    "id": 1,
    "name": "Start Journey2",
    "layout": [
      "___________________________________",
      "___________________________________",
      "___________________________________",
      "_______$___________________$_______",
      "######^####_____________####^######",
      "______^_____________________^______",
      "______^_______$_____$_______^______",
      "______^____#######^#######__^______",
      "______^___________^_________^______",
      "______#########___^___#########____",
      "__________________^________________",
      "__$_______________^______________$_",
      "#####^############^############^###",
      "_____^____________^____________^___",
      "_____^____$_______^_______$____^___",
      "_____^__#####_____^_____#####__^___",
      "_____^____________^____________^___",
      "_____^____________^____________^___",
      "##################^################",
      "###################################"
    ]
  },
  {
    "id": 2,
    "name": "Second level",
    "layout": [
      "___________________________________",
      "_________________$_________________",
      "__###^######___#####___######^###__",
      "_____^_____#___________#_____^_____",
      "_____^_____#___________#_____^_____",
      "__$__^__$__#____$_$____#__$__^__$__",
      "#####^####_#_#########_#_####^#####",
      "_____^_____#_____^_____#_____^_____",
      "___^_^___________^___________^_____",
      "###^#####________^________#########",
      "________#________^________#________",
      "________#___$____^____$___#________",
      "__#######_#####__^__#####_#######__",
      "__#______________^______________#__",
      "__#______________^______________#__",
      "__#___$__________^__________$___#__",
      "__#######________^________#######__",
      "________#________^________#________",
      "#################^#################",
      "###################################"
    ]
  },
  {
    "id": 3,
    "name": "Impossible",
    "layout": [
      "___________________________________",
      "___$___________________________$___",
      "#######_____________________#######",
      "______#_____________________#______",
      "______#______$_______$______#______",
      "______#____#####___#####____#______",
      "______#____#___________#____#______",
      "______#____#___$___$___#____#______",
      "______######___#####___######______",
      "___________#___#___#___#___________",
      "___________#___#___#___#___________",
      "___________#####_^_#####___________",
      "_________________^_________________",
      "__$______________^______________$__",
      "#####____________^____________#####",
      "____#____________^____________#____",
      "____#_____$______^______$_____#____",
      "____###########__^__###########____",
      "_________________^_________________",
      "###################################"
    ]
  },
  {
    "id": 4,
    "name": "Test level",
    "layout": [
      "___________________________________",
      "___________________________________",
      "#######_____________________#######",
      "______#_____________________#______",
      "______#_____________________#______",
      "______#____#####___#####____#______",
      "______#____#___________#____#______",
      "______#____#___________#____#______",
      "______######___#####___######______",
      "___________#___#___#___#___________",
      "___________#___#___#___#___________",
      "___________#####_^_#####___________",
      "_________________^_________________",
      "_________________^_________________",
      "#####____________^____________#####",
      "____#____________^____________#____",
      "____#____________^____________#____",
      "____###########__^__###########____",
      "_________________$_________________",
      "###################################"
    ]
  },
  {
    "id": 4,
    "name": "The hill",
    "layout": [
      "###################################",
      "#_________________________________#",
      "#_________________________________#",
      "#_________________________________#",
      "#_________________________________#",
      "#_________________________________#",
      "#______________$$_________________#",
      "#______________##_________________#",
      "#_____________####________________#",
      "#____________######_______________#",
      "#___________########______________#",
      "#__________##########_____________#",
      "#_________############____________#",
      "#________##############___________#",
      "#_______################__________#",
      "#______##################_________#",
      "#_____####################________#",
      "#____######################_______#",
      "#___########################______#",
      "###################################"
    ]
  }
]